ACACOYAGUA = 'Acacoyagua', _('Acacoyagua'),
ACALA = 'Acala', _('Acala'),
ACAPETAHUA = 'Acapetahua', _('Acapetahua'),
ALTAMIRANO = 'Altamirano', _('Altamirano'),
AMATÁN = 'Amatán', _('Amatán'),
AMATENANGODE_LA_FRONTERA = 'Amatenangode la Frontera', _('Amatenangode la Frontera'),
AMATENANGODEL_VALLE = 'Amatenangodel Valle', _('Amatenangodel Valle'),
ANGELALBINO_CORZO = 'AngelAlbino Corzo', _('AngelAlbino Corzo'),
ARRIAGA = 'Arriaga', _('Arriaga'),
BEJUCALDE_OCAMPO = 'Bejucalde Ocampo', _('Bejucalde Ocampo'),
BELLAVISTA = 'BellaVista', _('BellaVista'),
BERRIOZÁBAL = 'Berriozábal', _('Berriozábal'),
BOCHIL = 'Bochil', _('Bochil'),
ELBOSQUE = 'ElBosque', _('ElBosque'),
CACAHOATÁN = 'Cacahoatán', _('Cacahoatán'),
CATAZAJÁ = 'Catazajá', _('Catazajá'),
CINTALAPA = 'Cintalapa', _('Cintalapa'),
COAPILLA = 'Coapilla', _('Coapilla'),
COMITÁNDE_DOMÍNGUEZ = 'Comitánde Domínguez', _('Comitánde Domínguez'),
LACONCORDIA = 'LaConcordia', _('LaConcordia'),
COPAINALÁ = 'Copainalá', _('Copainalá'),
CHALCHIHUITÁN = 'Chalchihuitán', _('Chalchihuitán'),
CHAMULA = 'Chamula', _('Chamula'),
CHANAL = 'Chanal', _('Chanal'),
CHAPULTENANGO = 'Chapultenango', _('Chapultenango'),
CHENALHÓ = 'Chenalhó', _('Chenalhó'),
CHIAPADE_CORZO = 'Chiapade Corzo', _('Chiapade Corzo'),
CHIAPILLA = 'Chiapilla', _('Chiapilla'),
CHICOASÉN = 'Chicoasén', _('Chicoasén'),
CHICOMUSELO = 'Chicomuselo', _('Chicomuselo'),
CHILÓN = 'Chilón', _('Chilón'),
ESCUINTLA = 'Escuintla', _('Escuintla'),
FRANCISCOLEÓN = 'FranciscoLeón', _('FranciscoLeón'),
FRONTERACOMALAPA = 'FronteraComalapa', _('FronteraComalapa'),
FRONTERAHIDALGO = 'FronteraHidalgo', _('FronteraHidalgo'),
LAGRANDEZA = 'LaGrandeza', _('LaGrandeza'),
HUEHUETÁN = 'Huehuetán', _('Huehuetán'),
HUIXTÁN = 'Huixtán', _('Huixtán'),
HUITIUPÁN = 'Huitiupán', _('Huitiupán'),
HUIXTLA = 'Huixtla', _('Huixtla'),
LAINDEPENDENCIA = 'LaIndependencia', _('LaIndependencia'),
IXHUATÁN = 'Ixhuatán', _('Ixhuatán'),
IXTACOMITÁN = 'Ixtacomitán', _('Ixtacomitán'),
IXTAPA = 'Ixtapa', _('Ixtapa'),
IXTAPANGAJOYA = 'Ixtapangajoya', _('Ixtapangajoya'),
JIQUIPILAS = 'Jiquipilas', _('Jiquipilas'),
JITOTOL = 'Jitotol', _('Jitotol'),
JUÁREZ = 'Juárez', _('Juárez'),
LARRÁINZAR = 'Larráinzar', _('Larráinzar'),
LALIBERTAD = 'LaLibertad', _('LaLibertad'),
MAPASTEPEC = 'Mapastepec', _('Mapastepec'),
LASMARGARITAS = 'LasMargaritas', _('LasMargaritas'),
MAZAPADE_MADERO = 'Mazapade Madero', _('Mazapade Madero'),
MAZATÁN = 'Mazatán', _('Mazatán'),
METAPA = 'Metapa', _('Metapa'),
MITONTIC = 'Mitontic', _('Mitontic'),
MOTOZINTLA = 'Motozintla', _('Motozintla'),
NICOLÁSRUÍZ = 'NicolásRuíz', _('NicolásRuíz'),
OCOSINGO = 'Ocosingo', _('Ocosingo'),
OCOTEPEC = 'Ocotepec', _('Ocotepec'),
OCOZOCOAUTLADE_ESPINOSA = 'Ocozocoautlade Espinosa', _('Ocozocoautlade Espinosa'),
OSTUACÁN = 'Ostuacán', _('Ostuacán'),
OSUMACINTA = 'Osumacinta', _('Osumacinta'),
OXCHUC = 'Oxchuc', _('Oxchuc'),
PALENQUE = 'Palenque', _('Palenque'),
PANTELHÓ = 'Pantelhó', _('Pantelhó'),
PANTEPEC = 'Pantepec', _('Pantepec'),
PICHUCALCO = 'Pichucalco', _('Pichucalco'),
PIJIJIAPAN = 'Pijijiapan', _('Pijijiapan'),
ELPORVENIR = 'ElPorvenir', _('ElPorvenir'),
VILLACOMALTITLÁN = 'VillaComaltitlán', _('VillaComaltitlán'),
PUEBLONUEVO_SOLISTAHUACÁN = 'PuebloNuevo Solistahuacán', _('PuebloNuevo Solistahuacán'),
RAYÓN = 'Rayón', _('Rayón'),
REFORMA = 'Reforma', _('Reforma'),
LASROSAS = 'LasRosas', _('LasRosas'),
SABANILLA = 'Sabanilla', _('Sabanilla'),
SALTO_DEAGUA = 'Salto deAgua', _('Salto deAgua'),
SANCRISTÓBAL_DE_LAS_CASAS = 'SanCristóbal de las Casas', _('SanCristóbal de las Casas'),
SANFERNANDO = 'SanFernando', _('SanFernando'),
SILTEPEC = 'Siltepec', _('Siltepec'),
SIMOJOVEL = 'Simojovel', _('Simojovel'),
SITALÁ = 'Sitalá', _('Sitalá'),
SOCOLTENANGO = 'Socoltenango', _('Socoltenango'),
SOLOSUCHIAPA = 'Solosuchiapa', _('Solosuchiapa'),
SOYALÓ = 'Soyaló', _('Soyaló'),
SUCHIAPA = 'Suchiapa', _('Suchiapa'),
SUCHIATE = 'Suchiate', _('Suchiate'),
SUNUAPA = 'Sunuapa', _('Sunuapa'),
TAPACHULA = 'Tapachula', _('Tapachula'),
TAPALAPA = 'Tapalapa', _('Tapalapa'),
TAPILULA = 'Tapilula', _('Tapilula'),
TECPATÁN = 'Tecpatán', _('Tecpatán'),
TENEJAPA = 'Tenejapa', _('Tenejapa'),
TEOPISCA = 'Teopisca', _('Teopisca'),
TILA = 'Tila', _('Tila'),
TONALÁ = 'Tonalá', _('Tonalá'),
TOTOLAPA = 'Totolapa', _('Totolapa'),
LATRINITARIA = 'LaTrinitaria', _('LaTrinitaria'),
TUMBALÁ = 'Tumbalá', _('Tumbalá'),
TUXTLAGUTIÉRREZ = 'TuxtlaGutiérrez', _('TuxtlaGutiérrez'),
TUXTLACHICO = 'TuxtlaChico', _('TuxtlaChico'),
TUZANTÁN = 'Tuzantán', _('Tuzantán'),
TZIMOL = 'Tzimol', _('Tzimol'),
UNIÓNJUÁREZ = 'UniónJuárez', _('UniónJuárez'),
VENUSTIANOCARRANZA = 'VenustianoCarranza', _('VenustianoCarranza'),
VILLACORZO = 'VillaCorzo', _('VillaCorzo'),
VILLAFLORES = 'Villaflores', _('Villaflores'),
YAJALÓN = 'Yajalón', _('Yajalón'),
SANLUCAS = 'SanLucas', _('SanLucas'),
ZINACANTÁN = 'Zinacantán', _('Zinacantán'),
SAN_JUANCANCUC = 'San JuanCancuc', _('San JuanCancuc'),
ALDAMA = 'Aldama', _('Aldama'),
BENEMÉRITODE_LAS_AMÉRICAS = 'Beneméritode las Américas', _('Beneméritode las Américas'),
MARAVILLATENEJAPA = 'MaravillaTenejapa', _('MaravillaTenejapa'),
MARQUÉSDE_COMILLAS = 'Marquésde Comillas', _('Marquésde Comillas'),
MONTECRISTODE_GUERRERO = 'Montecristode Guerrero', _('Montecristode Guerrero'),
SANANDRÉS_DURAZNAL = 'SanAndrés Duraznal', _('SanAndrés Duraznal'),
SANTIAGOEL_PINAR = 'Santiagoel Pinar', _('Santiagoel Pinar'),
CAPITÁNLUIS_ANGEL_VIDAL = 'CapitánLuis Angel Vidal', _('CapitánLuis Angel Vidal'),
RINCÓNCHAMULA_SAN_PEDRO = 'RincónChamula San Pedro', _('RincónChamula San Pedro'),
ELPARRAL = 'ElParral', _('ElParral'),
EMILIANOZAPATA = 'EmilianoZapata', _('EmilianoZapata'),
MEZCALAPA = 'Mezcalapa', _('Mezcalapa'),
HONDURASDE_LA_SIERRA = 'Hondurasde la Sierra', _('Hondurasde la Sierra'),
